.############.
#............#
#..#########..###
#..#########..####
#.....@.......####
#.............###
#.....##......#
#.....##......#
#.....##......#
.######.######